111111111111111111
1000000000P0000001
100000000000000111
111110011111100001
1000000000C0100001
100011111000100C01
10C010000B000000E1
111111111111111111