11111111111111111111111111111
1P1C000R0011000000001000C0R01
10100000000000001011000010001
10111011001111111011111110111
10000001100000000000000000001
101000010CCCCC1000111001C0001
101010110010CCCCC110000110001
10100011000000000000001010101
10111111110011110110100100101
10101111111000000B0010C100101
10001C00100000000000100100001
10101C1000000000000000000C101
1R000000000R000000000C00C00E1
11111111111111111111111111111