11111111111
1P000000001
1000CCC0E01
1B000000001
11111111111